ADNP_indel_guide_1	gtggagactgattaagccgag
ANK2_indel_guide_1	gacattacggaaatgtcaacg
ANKRD11_indel_guide_6	gaggacgcgagtgtcaccgtg
ARID1B_indel_guide_1	gttgagtgcaagatcgaacgt
ASH1L_indel_guide_1	gcctatgaccaacgttcaagt
ASXL3_indel_guide_10	gagtaaggcttgaatctcgag
CHD2_indel_guide_2	gtcttacatccacagcacat
CHD8_indel_guide_1	gctttaatccagactacgtag
CTNNB1_indel_guide_1	gaaggttatgcaaggtcccag
CUL3_indel_guide_2	gtatcatcaataaataatgag
DLG4_indel_guide_1	gaggcgaattgtgatccaccg
DSCAM_indel_guide_6	gacttacgtttcacgtacagg
DYRK1A_indel_guide_1	gtgagaaacaccaatttccga
FOXP1_indel_guide_7	gctgctgaaaagccaactgct
GRIN2B_indel_guide_1	gcatagacggatgactcccgt
KMT2A_indel_guide_3	gatcctctataaaccgccgag
KMT2C_indel_guide_7	gttacacctgtaacaaatcag
KMT5B_indel_guide_2	gcaagagcagaacgttaacg
MAGEL2_indel_guide_8	ggaatctcgtgtggcaccgg
MBD5_indel_guide_11	ggtgcccgctatggctatgg
MED13L_indel_guide_2	gcaggacaaagaccctaccgt
MYT1L_indel_guide_22	gacaaaaacgaaaacctgggt
NAA15_indel_guide_2	gaaatattaaagaagctgca
NRXN1_indel_guide_3	gattaattctatataacagtg
POGZ_indel_guide_5	gcgaaattgagcattacatcg
PPM1D_indel_guide_3	gccagtgtggtcatcattcg
PTEN_indel_guide_1	gtcatctggattatagaccag
SCN2A_indel_guide_5	gatattggagctcccgccga
SETD5_indel_guide_2	gtgttggtgtgaatacccgg
SHANK2_indel_guide_4	gccgccggaaaccatccgatg
SIN3A_indel_guide_12	gcagatccgcagacatcctac
SMARCC2_indel_guide_1	gactcggggatcgacgacag
SRCAP_indel_guide_3	gcatatcgggagatagaatg
STXBP1_indel_guide_2	gtggtggatcagttaagcatg
SYNGAP1_indel_guide_2	gccgtaccatgctcgccgtg
TCF4_indel_guide_3	gctgatggagcatagacctg
WAC_indel_guide_5	gtccactggcaaacccactag
ZNF292_indel_guide_27	gcgaacaagcaggattcccat
KDM5B_indel_guide_3	gcagtgggctcacatatcag
PHF21A_indel_guide_1	gcattgtgatagctactcca
